16,16   
0000000000000000
0000000000000000
0000100000000000
0000100000000000
0000111110000000 /*11,4*/
0000000010000000
0000000010000000
0000000010000000
0000000010000000
0000000010000000
0000000010000000
0000000001000000 /*5,11*/
0000000000111100
0000000000000000
0000000000000000
0000000000000000
